{
  "א": [""],
  "ב": ["v"],
  "בּ": ["b"],
  "ג": ["g"],
  "ד": ["d"],
  "ה": ["h"],
  "ו": ["v"],
  "ז": ["z"],
  "ח": ["ch"],
  "חַ": ["ach"],
  "ט": ["t"],
  "י": ["y"],
  "כ": ["ch"],
  "כּ": ["k"],
  "ל": ["l"],
  "מ": ["m"],
  "נ": ["n"],
  "ס": ["s"],
  "ע": ["a"],
  "פ": ["f"],
  "פּ": ["p"],
  "צ": ["tz"],
  "ק": ["k"],
  "ר": ["r"],
  "שׁ": ["sh"],
  "ש": ["s"],
  "ת": ["s"],
  "תּ": ["t"],
  "ָ": ["o"],
  "ַ": ["a"],
  "ֵ": ["ei"],
  "ֶ": ["e"],
  "ִ": ["i"],
  "ֹ": ["o"],
  "וֹ": ["o"],
  "וּ": ["u"],
  "ֻ": ["u"],
  "ְ": ["e"]
}
